11111  11111

    11111
                11111

    11111

11111       
            11111
  
111 11111  

              11111
    11111