111111111 11111      

11111 11111       1111

11111 1   11111   11

111   111  111  1111

1 11 11 11 111  1111

11     11    11  1111
 
111111      111 1111

        1111